--------------------
--xxxx--------xxxxx-
--x--x--------x---x-
--x--x----x---x---x-
--x--xxxxx---xx---x-
s-x------------x--x-
--x---------e--x--x-
--xxxxxxxxxxxxxxxxx-
--------------------
